00000000
00101010
00000000
01010101
00000000
10101010
00000000
11111111
